0,0,0,0,0,0,0,0,0,0,0,0,0,0,0,0,0,0,0,0
0,0,0,6,6,6,6,6,6,6,1,6,6,6,6,6,6,0,0,0
0,0,6,6,6,6,6,6,6,1,8,1,6,6,6,6,6,6,0,0
0,6,6,6,6,6,6,6,1,8,8,8,1,6,6,6,6,6,6,0
0,6,6,6,6,6,6,1,8,2,8,2,8,1,6,6,6,6,6,0
0,6,6,6,6,6,1,8,3,2,8,2,3,8,1,6,6,6,6,0
0,6,6,6,6,1,8,2,2,8,8,8,2,2,8,1,6,6,6,0
8,8,8,8,8,8,8,8,8,8,8,8,8,8,8,8,8,8,8,8
0,6,6,6,6,1,8,2,2,8,8,8,2,2,8,1,6,6,6,0
0,6,6,6,6,6,1,8,3,2,8,2,3,8,1,6,6,6,6,0
0,6,6,6,6,6,6,1,8,2,8,2,8,1,6,6,6,6,6,0
0,6,6,6,6,6,6,6,1,8,8,8,1,6,6,6,6,6,6,0
0,0,6,6,6,6,6,6,6,1,8,1,6,6,6,6,6,6,0,0
0,0,0,6,6,6,6,6,6,6,1,6,6,6,6,6,6,0,0,0
0,0,0,0,0,0,0,0,0,0,0,0,0,0,0,0,0,0,0,0
