0,0,0,0,0,0,0,0,0,0,0,0,0,0,0,0,0,0,0,0
0,3,6,6,6,6,6,0,0,0,0,0,0,0,6,6,6,6,6,0
0,6,3,3,0,6,0,0,6,6,6,6,6,0,6,0,6,6,6,0
0,3,3,0,0,3,6,6,6,6,6,6,6,6,6,6,0,6,6,0
0,6,6,0,6,3,3,8,8,8,8,8,8,8,8,6,6,0,6,0
0,6,6,0,6,6,8,3,0,0,0,0,0,6,8,6,6,0,6,0
0,6,6,0,6,6,8,6,0,8,8,8,6,0,8,2,6,0,6,0
0,8,6,0,6,6,8,6,0,0,0,8,6,0,8,2,2,0,6,0
0,8,8,6,0,6,6,8,8,8,8,8,6,0,8,2,2,6,6,0
0,6,8,8,0,0,0,0,0,0,0,0,0,6,8,6,0,2,6,0
0,6,6,6,8,8,8,8,8,8,8,8,8,8,8,6,0,6,2,0
0,6,0,0,6,6,6,6,6,6,6,6,6,6,6,0,6,6,6,0
0,6,6,6,0,0,0,0,0,0,0,0,0,0,0,6,6,6,6,0
0,6,6,6,6,6,6,6,6,6,6,6,6,6,6,6,6,6,6,0
0,0,0,0,0,0,0,0,0,0,0,0,0,0,0,0,0,0,0,0
